###############################
# #                           #
# # #####   ##########   ######
#   #                #   #    #
#####     ########   #   #    #
#                    #   #    #
#   #   ####  ####   #        #
#   #   #        #   #        #
#       #                     #
###############################